10.ox
.ooo..o...
...o......
.oo..o....
..o..ooo.o
.....o....
..........
o....o....
......o...
..o.......
.....o....
