10.ox
.ooo...o..
.o.....o..
.......o..
......o...
.....o....
..........
..o.......
.o.o......
....o..o..
.o.oo.o...
